Subpop report generated 08-07-25 21:06:35

fastq:	/home/amorris/BioInf/BlooMine_WD/outbreak_paper/outbreak_paper_gp60/BlooMine_RUNDIR/UKP227_CP044417/Cp_gp60_IId/UKP227_CP044417.Cp_gp60_IId_BMfiltered.fq
flanks_fasta flanks:	/home/amorris/BioInf/BlooMine_WD/outbreak_paper/outbreak_paper_gp60/BlooMine_RUNDIR/tmp.Cp_gp60_IId_flanks.fa


Sequence variants:
TCGATGTTGATGATGATGATTATTACGATTATGATGATGATGATTATGATGATGATGATGATGTTGATGATGATGATGATGATGATTA	1
TCGATGTTGATGATGATGATGATGACGATGATGATGTTGATGATGATGATGATGATGATGATGATGATGATGATGATGATTATTATGA	1
TCGATGTTGATGATGATTATGATGACGATGATGATGATGATGATGATGATGATGATTATGATGATTATTATGATGATTATGATTATTA	1
TCGATGTTGATGATGATGATGATGACGATGATGATGATGATGATGATGATGATGATTATGATGATGATGATGATGATTATGATGATTA	1
TCGATGTTGATGATGATGATGATGACGATGATGATGATGATGATGATGATGATGATGATGATGATGATGATGATGATGATGATGAAGA	1
TCGATGTTGATGATGATGATGATGACGATGATGATGATGATGATGATGATGATGATGATGATGATGATGATGATGATGATGATTATGA	1
TCGATGTTGATGATGATGATGATGACGATGATGATGATGATGATGATGATGATTATTATGATGATTATGATTATGATGATGATGATTA	1
TCGATGTTGATGATGATGATGATGACGATGATGATGATGATGATTAAGATGATGATGATGATGATGATGATTATGATGATTATGATGA	1
TCGATGTTGATGATGATGATGATGACGATGATGATGATGATGATGATGATTATGATGATGATGATTATGATGATTATGATGATGATGA	1
TCGATGTTGATGATGATGATGATGACGATGATGATGATGATGATGATGATGATGATGATGATGATGATGATGATGATTATGATGATGA	2
TCGATGTTGATGATGATGATGATGACGATGATGATGATGATGATGATGATGATGATGATGATGATGATGATGATGATGATGATGATGA	5
TCGATGTTGATTATGATGATGATGACGATGATGATGATGATGATGATGATGATGATGATGATGATGATGATGATGATGATTATGATGA	1
TCGATGGTGATGATGATGATGATGACGATGATGATGATGATGATGATGATGATGATGATGTTGATGATGATGATTATGATGATGATTA	1
TCGATGGTGATGATGATGATGATGACGATGATGATGATGATGATGATGATGATGATGATGATGATGATGATGATGATGATGATGATGA	1
TCGATGTTGATGATGATGATGATGACGATGATGATGATGATGATGATGATGATGATTATGATGATGATGATGATTAAGATGATGATGA	1
TCGATGTTGATGATGATGATGATGACGATGATGATGATGATGATGATGATGATGATGATGATTATGATTATGATTATGATGATGATGA	1
TCGATGTTGATGATGATGATGATGACGATGATGATGATGATGATGATGATGATGATGATGATGATGATGATGATTATGATGATGATTA	1
TCGATGTTGAAGATGATGATGATGACGATGATGATGATGATGTTGATGATGATGATGATGATGATGATGATGATGATGATGATGATGA	1
TCGATGTTGATGATTATGATGATGATGACGATGATGATGATGATGATGATGATGATGATGATGATGATGATGATGATGATTATGATGATGA	1
TCGATGTTGATGATGATGATGATGACGATGATGATGATGATGATGATTATGATGATGATGATGATGATGATGATGATGATGATGATGA	1
TCGATGTTGATGATGATGATGATGAAGATGATGATGATGATGATGATGATGATGATGATGATGATGATGATGATGATGATGATGATGA	1
TCGATGGTGATGATGATGATGATGACGATGATGATGATGATGATGATGATGATGATGATGATGATGATGATGATTATGATGATGATGA	1
TCGATGTTGATGATGATGATGATGACGATGATGATGATGATGATGATGATGATGATGATTATGATGATGATGATGATGATGATGATGA	1

Length variants:
88	27
91	1

